0	0	0	0	0	0	0	0	0	0	0	0	0	0	0	0	0	0	0	0	
0	0	0	0	0	0	0	0	0	0	0	0	0	0	0	0	0	0	0	0	
0	0	0	0	0	0	0	0	0	0	0	0	0	0	0	0	0	0	0	0	
0	0	0	0	0	0	0	0	0	0	0	0	0	0	0	0	0	0	0	0	
0	0	0	0	0	0	0	0	0	0	0	0	0	0	0	0	0	0	0	0	
0	0	0	0	0	0	0	0	0	0	0	0	0	0	0	0	0	0	0	0	
0	0	0	0	0	0	0	0	0	0	0	0	0	0	0	0	0	0	0	0	
0	0	0	0	0	0	0	0	0	0	0	0	0	0	0	0	0	0	0	0	
0	0	0	0	0	0	0	0	0	0	0	0	0	0	0	0	0	0	0	0	
0	0	0	0	0	0	0	0	0	0	0	0	0	0	0	0	0	0	0	0	
0	0	0	0	0	0	0	0	0	0	0	0	0	0	0	0	0	0	0	0	
0	0	0	0	0	0	0	0	0	0	0	0	0	0	0	0	0	0	0	0	
0	0	0	0	0	0	0	0	0	0	0	0	0	0	0	0	0	0	0	0	
10	10	10	10	10	10	10	10	10	0	0	0	0	0	0	0	0	0	0	0	
10	10	10	10	10	10	10	10	10	10	0	0	0	0	0	0	0	0	0	0	
10	10	10	10	10	10	10	10	10	10	10	0	0	0	0	0	0	2	2	0	
10	10	10	10	10	10	10	10	10	10	10	10	0	0	0	0	0	2	2	0	
10	10	10	10	10	10	10	10	10	10	10	10	0	0	0	0	0	0	0	0	
10	10	10	10	10	10	10	10	10	10	10	10	0	0	0	0	0	0	0	0	
10	10	10	10	10	10	10	10	10	10	10	10	0	0	0	0	0	0	0	0	
2	10	10	10	10	10	10	10	10	10	10	10	0	0	0	0	0	0	0	0	
2	2	10	10	10	10	10	10	10	10	10	0	0	0	2	2	0	0	0	0	
2	2	2	2	2	2	10	10	10	2	2	0	0	0	2	2	0	0	0	0	
2	2	2	2	2	2	10	10	10	2	2	0	0	0	0	0	0	0	0	0	
2	2	2	2	2	2	10	10	10	2	2	0	0	0	0	0	0	0	0	0	
2	2	2	2	2	2	10	10	10	2	2	0	0	0	0	0	0	0	0	0	
2	2	2	2	2	2	10	10	10	2	2	0	0	0	0	0	0	0	0	0	
2	2	2	2	2	2	10	10	10	2	2	2	0	0	0	0	2	2	0	0	
2	2	2	2	2	2	10	16	16	2	2	2	0	0	0	0	2	2	0	0	
2	2	2	2	2	2	10	16	16	2	2	2	2	0	0	0	0	0	0	0	
2	2	2	2	2	2	10	16	16	2	2	2	2	2	0	0	0	0	0	0	
2	2	2	2	2	2	10	16	16	2	2	2	2	2	2	2	2	2	2	2	
2	2	2	2	2	2	16	16	16	10	10	10	10	10	10	10	10	10	10	10	
2	2	2	2	2	2	16	16	16	10	10	10	10	10	10	10	10	10	10	10	
2	2	2	2	2	2	16	16	16	2	2	2	2	2	2	2	2	2	2	2	
2	2	2	2	2	2	16	16	16	2	2	2	2	2	2	2	2	2	2	2	
5	5	5	14	2	2	10	10	10	2	2	2	2	6	5	5	5	5	5	5	
12	12	12	12	14	2	10	10	10	2	2	2	6	12	12	12	12	12	12	12	
12	12	12	12	12	14	10	10	10	2	2	6	12	12	12	12	12	12	12	12	
12	12	12	12	12	12	12	12	12	12	12	12	12	12	12	12	12	12	12	12	
12	12	12	12	12	12	12	12	12	12	12	12	12	12	12	12	12	12	12	12	
12	12	12	12	12	12	12	12	12	12	12	12	12	12	12	12	12	12	12	12	
12	12	12	12	12	12	12	12	12	12	12	12	12	12	12	12	12	12	12	12	
12	12	12	12	12	12	12	12	12	12	12	12	12	12	12	12	12	12	12	12	
12	12	12	12	12	12	12	12	12	12	12	12	12	12	12	12	12	12	12	12	
12	12	12	12	15	2	10	10	10	2	2	12	12	12	12	12	12	12	12	12	
12	12	12	15	2	2	10	10	10	2	2	7	12	12	12	12	12	12	12	12	
13	13	15	2	2	2	10	10	10	2	2	2	7	12	12	12	12	12	12	12	
2	2	2	2	2	2	10	10	10	2	2	2	2	7	13	13	13	13	13	13	
2	2	2	2	2	2	10	10	10	2	2	2	2	2	2	2	2	2	2	2	
2	2	2	2	2	2	10	10	10	2	2	2	2	2	2	2	2	2	2	2	
2	2	2	2	2	2	10	10	10	10	10	10	10	2	2	2	2	2	2	2	
2	2	2	2	2	10	10	10	10	10	10	10	10	2	2	2	2	2	2	2	
2	2	2	2	2	10	10	10	2	2	10	10	10	2	2	2	2	2	2	2	
2	2	2	2	2	10	10	10	2	2	10	10	10	2	2	2	2	2	2	2	
2	2	2	2	2	10	10	10	2	2	10	10	10	2	2	2	2	2	2	2	
2	2	2	2	2	10	10	10	2	2	10	10	10	2	2	2	2	2	2	2	
2	2	2	2	2	10	10	10	2	2	10	10	10	2	2	2	2	2	2	2	
2	2	2	2	2	10	10	10	2	2	10	10	10	2	2	2	2	2	2	2	
2	2	2	2	10	10	10	2	2	2	10	10	10	2	2	2	2	2	2	2	
2	2	2	2	10	10	10	2	2	2	10	10	10	2	2	2	2	2	2	2	
2	2	2	2	10	10	10	2	2	2	10	10	10	2	2	2	2	2	2	2	
2	2	2	2	10	10	10	2	2	2	10	10	10	2	2	2	2	2	2	2	
2	2	2	2	10	10	10	2	2	2	10	10	10	2	2	2	2	2	2	2	
2	2	2	2	10	10	10	2	2	2	10	10	10	2	2	2	2	2	2	2	
2	2	2	2	10	10	10	2	2	2	10	10	10	2	2	2	6	5	5	5	
2	2	2	10	10	10	2	2	2	2	10	10	10	2	2	6	12	12	12	12	
2	2	2	10	10	10	2	2	2	2	10	10	10	2	2	12	12	12	12	12	
2	2	2	10	10	10	2	2	2	2	10	10	10	2	2	12	12	12	12	12	
2	2	2	10	10	10	10	10	10	10	10	10	10	2	2	12	12	12	12	12	
2	2	2	10	10	10	10	10	10	10	10	10	10	2	2	12	12	12	12	12	
2	2	2	2	2	2	2	10	10	10	2	2	2	2	2	7	12	12	12	12	
0	0	0	0	0	0	0	0	0	10	2	2	2	2	2	2	7	13	13	13	
0	0	0	0	0	0	0	0	0	0	0	0	0	0	2	2	2	2	2	2	
2	2	2	2	2	2	2	2	0	0	0	0	0	0	0	0	0	0	0	2	
2	2	2	2	2	2	2	2	2	2	2	2	2	0	0	0	0	0	0	0	
2	2	2	2	2	2	2	2	2	2	2	2	2	2	2	2	2	2	0	0	
2	2	2	2	2	2	2	2	2	2	2	2	2	2	2	2	2	2	2	2	
2	2	2	2	2	2	2	2	2	2	2	2	2	2	2	2	2	2	2	2	
2	2	2	2	2	2	2	2	2	2	2	2	2	2	2	2	2	2	2	2	
2	2	2	2	2	2	2	2	2	2	2	2	2	2	2	2	2	2	2	2	
2	2	2	2	2	2	2	2	2	2	2	2	2	2	2	2	2	2	2	2	
2	2	2	2	2	2	2	2	2	2	2	2	2	2	2	2	2	2	2	2	
2	2	2	2	2	2	2	2	2	2	2	2	2	2	2	2	2	2	2	2	
2	2	2	2	2	2	2	2	2	2	2	2	2	2	2	2	2	2	2	2	
5	5	5	5	5	14	2	2	2	2	2	2	2	2	2	2	6	5	5	5	
12	12	12	12	12	12	14	2	2	2	2	2	2	2	2	6	12	12	12	12	
12	12	12	12	12	12	12	12	12	12	12	12	12	12	12	12	12	12	12	12	
12	12	12	12	12	12	12	12	12	12	12	12	12	12	12	12	12	12	12	12	
12	12	12	12	12	12	12	12	12	12	12	12	12	12	12	12	12	12	12	12	
12	12	12	12	12	12	12	12	12	12	12	12	12	12	12	12	12	12	12	12	
12	12	12	12	12	12	12	12	12	12	12	12	12	12	12	12	12	12	12	12	
12	12	12	12	12	12	12	12	12	12	12	12	12	12	12	12	12	12	12	12	
12	12	12	12	12	12	12	12	12	12	12	12	12	12	12	12	12	12	12	12	
12	12	12	12	12	12	12	12	12	12	12	12	12	12	12	12	12	12	12	12	
12	12	12	12	12	12	12	12	12	12	12	12	12	12	12	12	12	12	12	12	
12	12	12	12	12	12	12	12	12	12	12	12	12	12	12	12	12	12	12	12	
12	12	12	12	12	12	12	12	12	12	12	12	12	12	12	12	12	12	12	12	
12	12	12	12	12	12	12	12	12	12	12	12	12	12	12	12	12	12	12	12	
12	12	12	12	12	12	12	12	12	12	12	12	12	12	12	12	12	12	12	12	
